[6,11]
(0,1)
(10,3)
(1,4,9,1)
(1,2,1,2)
(3,0,1,3)
(5,1,1,3)
(7,0,1,3)
(9,1,1,3)